00100000
00100011
00111110
00000000
01111110
01000010
01000010
01111110
01000000
